26 9 0
222222221
121112221
121212221
121212221
121212221
121211111
121212222
121111111
322222221
111112221
422212221
111212221
111212221
111212221
121211111
121222222
121311222
122211222
322221111
121122321
121121121
121121121
121121121
121111121
122212221
011111411
